#,Name,Release,Peak Users,Positive,Negative,Total,Rating
1,Vampire Survivors,10/20/2022,77061,202482,2785,205267,0.9742
2,Stray,7/19/2022,62963,120328,3302,123630,0.9594
3,Entropy : Zero 2,8/20/2022,3751,17429,296,17725,0.9579
4,Neon White,6/16/2022,3277,12040,198,12238,0.9554
5,PowerWash Simulator,7/14/2022,10512,37368,970,38338,0.9549
6,God of War,1/14/2022,73529,104938,3380,108318,0.9545
7,Placid Plastic Duck Simulator,7/6/2022,647,9562,155,9717,0.9535
8,Persona 5 Royal,10/21/2022,35474,41507,1206,42713,0.9527
9,CULTIC,10/13/2022,738,4456,52,4508,0.9497
10,Wobbledogs,3/15/2022,591,7359,132,7491,0.9495
11,Marvel’s Spider-Man Remastered,8/12/2022,66436,71548,2617,74165,0.9488
12,The Case of the Golden Idol,10/13/2022,520,4312,53,4365,0.9487
13,Teardown,4/21/2022,8339,72400,2741,75141,0.9477
14,Trombone Champ,9/16/2022,1067,7059,140,7199,0.9474
15,Lil Gator Game,12/14/2022,458,2688,19,2707,0.9473
16,Patrick's Parabox,3/29/2022,592,2620,18,2638,0.9471
17,The Looker,6/17/2022,1632,11770,303,12073,0.9469
18,Dorfromantik,4/28/2022,7101,22798,742,23540,0.9459
19,Ib,4/11/2022,2745,2730,25,2755,0.9457
20,A Castle Full of Cats,11/9/2022,190,2121,11,2132,0.9456
21,A Building Full of Cats,7/7/2022,115,2709,27,2736,0.9449
22,Stacklands,4/8/2022,5186,19773,666,20439,0.9439
23,Half-Life 2: VR Mod,9/16/2022,1793,4610,95,4705,0.9422
24,Metal: Hellsinger,9/15/2022,3569,10083,307,10390,0.9414
25,Lost in Play,8/10/2022,511,3361,59,3420,0.9411
26,Monster Prom 3: Monster Roadtrip,10/21/2022,1774,2336,28,2364,0.9411
27,The Planet Crafter,3/24/2022,14253,21645,827,22472,0.9405
28,Outcore,9/26/2022,453,6272,168,6440,0.9401
29,Monument Valley,7/12/2022,323,2502,36,2538,0.9399
30,Dungeon Munchies,7/27/2022,861,5995,161,6156,0.9396
31,Outpath: First Journey,12/17/2022,896,3593,74,3667,0.9393
32,ASTLIBRA ～生きた証～ Revision,10/13/2022,7000,16904,638,17542,0.9392
33,SuchArt!,10/13/2022,920,3508,75,3583,0.9383
34,Bugsnax,4/28/2022,949,3744,86,3830,0.9377
35,提西探险社,12/2/2022,175,2223,34,2257,0.9375
36,Aokana - EXTRA2,12/16/2022,531,1079,2,1081,0.9373
37,Cafe Stella,3/25/2022,1415,2633,49,2682,0.937
38,月に寄りそう乙女の作法,6/17/2022,689,2184,35,2219,0.9366
39,SIGNALIS,10/27/2022,872,9282,327,9609,0.9365
40,Sucker for Love,1/20/2022,247,2173,35,2208,0.9365
41,Frog Detective 3: Corruption at Cowboy County,10/27/2022,220,1202,7,1209,0.9359
42,Tiny Rogues,9/23/2022,1694,3254,76,3330,0.9357
43,FreshWomen - Season 1,8/19/2022,3383,12455,490,12945,0.9354
44,Downfall - A Slay the Spire Fan Expansion,3/25/2022,3132,2800,62,2862,0.9348
45,At Home Alone Final,1/1/2022,389,4943,151,5094,0.9343
46,Dialtown: Phone Dating Sim,2/14/2022,133,1146,9,1155,0.9333
47,怠惰的怪獸公主不想工作,6/22/2022,1102,4327,131,4458,0.9331
48,PlateUp!,8/4/2022,12460,13977,604,14581,0.933
49,Tinykin,8/30/2022,262,1359,16,1375,0.9329
50,Will You Snail?,3/9/2022,705,2297,49,2346,0.9328
51,枝江畔之梦,1/27/2022,541,1453,20,1473,0.9323
52,Chop Goblins,12/12/2022,198,1627,26,1653,0.9322
53,Retrowave,5/7/2022,638,13202,585,13787,0.9316
54,REFLEXIA Prototype ver.,8/31/2022,580,3117,90,3207,0.9304
55,NEEDY GIRL OVERDOSE,1/21/2022,3674,26636,1377,28013,0.9302
56,BABBDI,12/22/2022,117,2004,45,2049,0.9299
57,Against the Storm,11/1/2022,8425,12669,586,13255,0.9296
58,POSTAL Brain Damaged,6/9/2022,764,5368,199,5567,0.9296
59,Slime Rancher 2,9/22/2022,21524,20613,1068,21681,0.9284
60,The Upturned,3/23/2022,38,768,4,772,0.928
61,Dwarf Fortress,12/6/2022,28340,19917,1041,20958,0.9278
62,Super Lesbian Animal RPG,12/20/2022,119,830,6,836,0.9278
63,Beacon Pines,9/22/2022,198,1522,31,1553,0.9275
64,Farmer Against Potatoes Idle,8/25/2022,8951,3783,135,3918,0.927
65,I Was a Teenage Exocolonist,8/25/2022,688,1961,50,2011,0.927
66,COMPOUND,7/19/2022,102,1812,44,1856,0.9269
67,Raft,6/20/2022,101096,263204,17756,280960,0.9268
68,Cult of the Lamb,8/11/2022,61780,53125,3193,56318,0.9268
69,Aperture Desk Job,3/1/2022,3519,18979,1010,19989,0.9267
70,Save Room - Organization Puzzle,4/28/2022,147,1789,44,1833,0.9264
71,Nova Lands: Emilia's Mission,10/17/2022,806,1793,45,1838,0.926
72,Fear & Hunger 2: Termina,12/9/2022,608,2683,86,2769,0.9258
73,私のリアルは充実しすぎている フルボイス版,12/16/2022,1340,2716,88,2804,0.9257
74,Nightmare of Decay,5/3/2022,241,2662,86,2748,0.9255
75,Animal Revolt Battle Simulator,4/15/2022,1091,4356,177,4533,0.9244
76,Sudocats,3/14/2022,37,729,6,735,0.9244
77,Supraland Six Inches Under,1/14/2022,1973,2399,77,2476,0.9243
78,Insomnia: Theater in the Head,12/16/2022,80,1299,28,1327,0.9239
79,Dinkum,7/14/2022,13412,16799,936,17735,0.9237
80,时间切片：序章,11/24/2022,196,1684,45,1729,0.9237
81,Resonance of the Ocean,7/8/2022,29,1107,21,1128,0.9234
82,Cosmoteer: Starship Architect & Commander,10/24/2022,13794,7044,338,7382,0.9231
83,Judgment,9/14/2022,5606,5042,223,5265,0.923
84,Spark the Electric Jester 3,8/14/2022,239,1284,29,1313,0.9229
85,Symphony of War: The Nephilim Saga,6/10/2022,4383,8039,401,8440,0.9227
86,Soulstone Survivors: Prologue,8/26/2022,4818,3958,164,4122,0.9227
87,Spaceflight Simulator,2/18/2022,469,3400,134,3534,0.9226
88,Strange Horticulture,1/21/2022,1356,7634,380,8014,0.9223
89,Zodiacats,1/21/2022,37,580,3,583,0.9221
90,daydream 白日夢,3/2/2022,41,826,12,838,0.9217
91,POPGOES Arcade,7/1/2022,258,1196,28,1224,0.921
92,The Past Within,11/2/2022,11642,10625,584,11209,0.9209
93,SANABI,6/20/2022,415,2850,111,2961,0.9208
94,10 Minutes Till Dawn,5/11/2022,3444,4100,182,4282,0.9206
95,The Stanley Parable: Ultra Deluxe,4/27/2022,13802,21323,1315,22638,0.9203
96,Lunacid,3/15/2022,547,2332,85,2417,0.9203
97,BROK the InvestiGator,8/26/2022,223,789,12,801,0.9202
98,Pentiment,11/15/2022,1250,3994,178,4172,0.9201
99,Shadows Over Loathing,11/11/2022,3077,2246,81,2327,0.9201
100,Ever Seen A Cat?,1/18/2022,15,568,4,572,0.9201
101,FAITH,10/21/2022,693,3390,146,3536,0.9195
102,Lily's Well,1/4/2022,140,1503,45,1548,0.9193
103,Marvel's Spider-Man: Miles Morales,11/18/2022,13539,21784,1375,23159,0.9192
104,A Taste of the Past,3/11/2022,47,1155,29,1184,0.919
105,Love Delivery,5/30/2022,546,2071,76,2147,0.9185
106,Warsim: The Realm of Aslona,12/20/2022,263,1214,33,1247,0.9182
107,Lost Judgment,9/14/2022,2269,3503,160,3663,0.9177
108,Not For Broadcast,1/25/2022,864,9083,521,9604,0.9176
109,所向之未来 - Towards Future,2/18/2022,28,548,5,553,0.9176
110,恋爱绮谭 不存在的真相,10/28/2022,437,1546,51,1597,0.9173
111,Leap of Faith,2/11/2022,505,1456,48,1504,0.9163
112,The Legend of Heroes: Trails from Zero,9/27/2022,817,771,15,786,0.9163
113,Capybara Spa,3/14/2022,188,1173,34,1207,0.9161
114,The Complex: Found Footage,8/18/2022,235,6207,345,6552,0.9156
115,Teenage Mutant Ninja Turtles: Shredder's Revenge,6/16/2022,11933,10867,669,11536,0.9155
116,Last Command,10/25/2022,422,1452,50,1502,0.9151
117,Wylde Flowers,9/20/2022,653,1104,32,1136,0.9151
118,Tribal Hunter,8/22/2022,270,1142,34,1176,0.915
119,Roadwarden,9/12/2022,622,2271,97,2368,0.9148
120,Seal World,4/1/2022,14,383,1,384,0.9145
121,My Sticker Book,8/24/2022,27,959,26,985,0.9142
122,Melatonin,12/15/2022,314,3166,154,3320,0.9141
123,Klonoa Phantasy Reverie Series,7/7/2022,753,1303,44,1347,0.9139
124,ELDEN RING,2/24/2022,953426,646268,55564,701832,0.9135
125,14 Minesweeper Variants,11/14/2022,346,551,8,559,0.9134
126,Disney Dreamlight Valley,9/6/2022,14314,11981,781,12762,0.9133
127,Magical Girl Celesphonia,5/7/2022,1583,1747,70,1817,0.9133
128,Dungeon Alchemist,3/31/2022,1181,1837,76,1913,0.913
129,Bendy and the Dark Revival,11/15/2022,5703,8131,503,8634,0.9129
130,Shinobi Warfare,6/14/2022,281,1944,83,2027,0.9127
131,Cut,1/15/2022,20,1226,42,1268,0.9126
132,Treasure of Nadia,2/16/2022,1699,4692,266,4958,0.9119
133,How Fish Is Made,1/14/2022,96,2397,113,2510,0.9119
134,Lunistice,11/10/2022,104,992,31,1023,0.9114
135,Garden Galaxy,12/14/2022,415,767,20,787,0.9109
136,Cave Crawler,1/23/2022,107,2608,130,2738,0.9108
137,Error143,7/26/2022,494,2301,110,2411,0.9108
138,Card Survival: Tropical Island,9/16/2022,2144,1566,66,1632,0.91
139,I Frog-ot,12/16/2022,25,401,4,405,0.9098
140,Acquitted,5/2/2022,137,765,21,786,0.9097
141,Sonic Frontiers,11/8/2022,19181,16742,1219,17961,0.9095
142,click to ten,3/9/2022,49,2534,130,2664,0.9092
143,Super Kiwi 64,12/2/2022,94,955,32,987,0.9089
144,Her New Memory,2/8/2022,261,3243,180,3423,0.9088
145,Flatworld,4/28/2022,442,786,23,809,0.9088
146,her tears were my light,9/28/2022,5,311,1,312,0.9087
147,暖雪 Warm Snow,1/19/2022,44702,25215,1950,27165,0.9084
148,Linelith,5/19/2022,65,454,7,461,0.9084
149,Shredders,3/16/2022,697,1669,76,1745,0.9082
150,Deadeye Deepfake Simulacrum,10/13/2022,45,356,3,359,0.9081
151,Freedom Planet 2,9/13/2022,964,1211,48,1259,0.908
152,Prodeus,9/23/2022,716,5136,322,5458,0.9079
153,Gun Devil,8/2/2022,106,981,35,1016,0.9077
154,Yoiyami Dancers: Twilight Danmaku Dancers,9/28/2022,77,350,3,353,0.9075
155,《文字遊戲》,1/21/2022,4105,4852,304,5156,0.9074
156,Five nights at Floppa,2/18/2022,40,976,35,1011,0.9074
157,Her World,10/6/2022,137,373,4,377,0.9074
158,Gloomwood,9/5/2022,1939,3652,218,3870,0.9068
159,Endling - Extinction is Forever,7/19/2022,232,1014,38,1052,0.9068
160,Hook 2,6/29/2022,59,499,10,509,0.9068
161,Kiwi Clicker,7/29/2022,1320,961,35,996,0.9067
162,Citizen Sleeper,5/5/2022,570,3635,218,3853,0.9065
163,The Lost Dachshund,5/17/2022,28,535,12,547,0.9064
164,TYRONE vs COPS,2/12/2022,70,1765,87,1852,0.906
165,Shadow Burglar,3/1/2022,36,621,17,638,0.9056
166,常轨脱离Creative,9/30/2022,184,579,15,594,0.9054
167,DEATH STRANDING DIRECTOR'S CUT,3/30/2022,6093,17838,1399,19237,0.9053
168,Jaded,4/29/2022,73,575,15,590,0.9051
169,Railbound,9/6/2022,365,901,34,935,0.9045
170,The Zachtronics Solitaire Collection,9/6/2022,128,384,6,390,0.9042
171,Weed Shop 3,4/21/2022,2551,3086,187,3273,0.9041
172,HYPER DEMON,9/19/2022,365,1762,91,1853,0.9041
173,Baldi's Basics Classic Remastered,10/21/2022,847,5059,342,5401,0.9038
174,Rock Life: The Rock Simulator,7/21/2022,515,1623,82,1705,0.9038
175,GNOSIA,1/23/2022,1140,2055,113,2168,0.9035
176,打工吧！天使酱 ~天使在魔界的劳改生活~,7/22/2022,40,371,6,377,0.903
177,瘟疫清零计划 Project Zero,9/11/2022,1172,2680,161,2841,0.9029
178,Urbek City Builder: Prologue,3/10/2022,475,1466,73,1539,0.9029
179,The Spirit and the Mouse,9/26/2022,57,349,5,354,0.9029
180,Countryball: Europe 1890,3/21/2022,78,349,5,354,0.9029
181,One-armed cook,8/30/2022,2408,13830,1099,14929,0.9028
182,Iron Lung,3/10/2022,173,6154,439,6593,0.9027
183,Kinkoi Golden Time,7/15/2022,328,409,8,417,0.9027
184,奇怪的RPG,10/1/2022,1160,3146,198,3344,0.9025
185,Moss: Book II,10/20/2022,64,277,2,279,0.9025
186,けものフレンズ Cellien May Cry,5/1/2022,302,677,23,700,0.9022
187,Kalinur,8/18/2022,44,423,9,432,0.9021
188,Seraph's Last Stand,3/23/2022,771,3080,195,3275,0.9019
189,The Last Clockwinder,6/2/2022,64,439,10,449,0.9018
190,McPixel 3,11/14/2022,99,597,19,616,0.9013
191,Atelier Sophie 2: The Alchemist of the Mysterious Dream,2/25/2022,3622,1701,93,1794,0.9012
192,Captain of Industry,5/31/2022,6135,3784,255,4039,0.901
193,Ever Seen A Cat? 2,5/30/2022,20,331,5,336,0.901
194,Hatsune Miku: Project DIVA Mega Mix+,5/26/2022,2730,10518,842,11360,0.9003
195,Ex-Zodiac,7/21/2022,90,497,14,511,0.9003
196,Priest Simulator,10/6/2022,238,564,18,582,0.9001
197,TUNIC,3/16/2022,2501,8839,699,9538,0.8997
198,Potion Craft: Alchemist Simulator,12/13/2022,10161,20423,1776,22199,0.8993
199,Nightmare Reaper,3/28/2022,1159,2909,193,3102,0.8989
200,Ravenous Devils,4/29/2022,2415,5790,437,6227,0.8988
201,Mosaique Neko Waifus 5,10/26/2022,138,892,40,932,0.8987
202,DRAINUS,5/22/2022,194,656,25,681,0.8983
203,Robin Morningwood Adventure,9/30/2022,140,492,15,507,0.8983
204,LEGO® Star Wars™: The Skywalker Saga,4/5/2022,82517,35674,3293,38967,0.8982
205,IronWolf VR,4/12/2022,45,1012,49,1061,0.8981
206,梦魇：无归 Nightmare without return,9/30/2022,300,556,19,575,0.898
207,Growing My Grandpa!,7/12/2022,25,264,3,267,0.8979
208,Quaver,8/19/2022,891,11597,976,12573,0.8977
209,Little Noah: Scion of Paradise,6/28/2022,1478,1389,77,1466,0.8976
210,Hana no No ni Saku Utakata no,4/22/2022,238,415,11,426,0.8976
211,Choice of Life: Middle Ages 2,9/30/2022,261,481,15,496,0.8973
212,Pulling No Punches,8/10/2022,122,445,13,458,0.8971
213,Kena: Bridge of Spirits,9/27/2022,2643,8956,739,9695,0.897
214,Monument Valley 2,7/12/2022,105,1076,55,1131,0.897
215,东方秘剑录,2/14/2022,55,653,26,679,0.8969
216,旅行こいし: デスクトップ少女 ~ Koishi Navigation Desktop Youkai,8/2/2022,482,638,25,663,0.8969
217,The Testing Chamber,3/28/2022,23,493,16,509,0.8968
218,I'm on Observation Duty 5,5/13/2022,244,538,19,557,0.8965
219,JellyCar Worlds,12/8/2022,97,439,13,452,0.8965
220,Rogue: Genesia,9/19/2022,5178,4275,320,4595,0.8964
221,CaseCracker,12/19/2022,638,1973,125,2098,0.8964
222,Core Keeper,3/8/2022,34508,23984,2207,26191,0.8963
223,Tag: The Power of Paint,4/18/2022,77,567,21,588,0.8962
224,ナツノカナタ,8/17/2022,296,703,30,733,0.8961
225,Depersonalization,12/20/2022,3044,2984,211,3195,0.8957
226,Last Call BBS,8/3/2022,770,855,41,896,0.8956
227,Instruments of Destruction,3/2/2022,335,782,36,818,0.8955
228,Freshly Frosted,6/10/2022,43,247,3,250,0.8955
229,Tree Simulator 2023,4/1/2022,160,599,24,623,0.895
230,Return to Monkey Island,9/19/2022,15539,6936,573,7509,0.8948
231,Shattered Pixel Dungeon,3/23/2022,336,864,43,907,0.8943
232,SuperTux,1/12/2022,82,707,32,739,0.8942
233,Ninja Village,5/23/2022,254,258,4,262,0.8942
234,Owinka Shooter,7/23/2022,44,643,28,671,0.8937
235,A=B,3/29/2022,280,554,22,576,0.8937
236,Hidden Cats in London,12/16/2022,16,215,2,217,0.8937
237,Football Coach: College Dynasty,12/12/2022,220,379,11,390,0.8936
238,Choo-Choo Charles,12/9/2022,4058,10906,972,11878,0.8934
239,Soda Crisis,5/24/2022,1631,2456,174,2630,0.8933
240,Lucy Dreaming,10/18/2022,49,233,3,236,0.8933
241,Vault of the Void,10/4/2022,1003,2097,144,2241,0.893
242,Touch Some Grass,4/11/2022,423,606,26,632,0.893
243,Trapped with Jester,10/10/2022,34,688,32,720,0.8927
244,FAR: Changing Tides,3/1/2022,989,2873,213,3086,0.8926
245,Charlie in the MoistVerse of Madness,3/11/2022,63,338,9,347,0.8926
246,Beeny,10/15/2022,11,267,5,272,0.8926
247,Ten Trials of Babel: The Doppelganger Maze,3/14/2022,642,2989,225,3214,0.8922
248,Please Be Happy,11/21/2022,72,206,2,208,0.8922
249,DOUKYUUSEI,4/15/2022,1325,1263,77,1340,0.8919
250,Escape Dungeon 2,1/14/2022,868,1250,76,1326,0.8919
